O moguæ prijevremen izbor nisa nikad razgovara s Andrej Plenkoviæ Nij mi to ni spomen ka e za Globus Ivan Vrdoljak za mnog uz premijer i stup sad nje Vlad za koj èelnik HNS a tvrd da je dobr al da je dobi pack od Europsk komisij Treba	treba
to ozbiljn shvatit poruèi je stranaèk koleg na tradicionaln okupljanj vodstv strank koj je ova put odr an u Tuheljsk toplic proteklog vikend Vrdoljak im èudnovat iskustv bio	bio
je með najbl im suradnik Zoran Milanoviæ a sad je i Plenkoviæ iak zbog razn razlog nij bar ne jo do sad u ao u Vlad Ka e nisa nikad tajn pregovara s Tomislav Karamark al s njegov nasljednik danas ef HDZ a i premijer oèit jest Dogovor koj je stvori koalicij koj leð èuva i Milorad Pupovc dobr se dr i al prav izazov tek predstoj Ono to se mnog èin da je Plenkoviæev prednost vrhunsk obrazovanj uglaðenost europejstv kulturn ophoðenj istinsk elj da demokratizir i HDZ i Hrvatsk na ov sklisk balkansk teren brz se mo e pretvori u optereæenj To iskusn Ivan Vrdoljak dobr zna pogotov to i ekonomij ba ne id kak bi	bi
treba pa diplomatsk uljuðen al ipak posv jasn ka e da je posljednj izvj taj iz Bruxelles na nek naèin i opomen Vlad Medij su	su
posljednj dan kalkulir da Andrej Plenkoviæ razm lja o izvanredn izbor Imat li o tom nek saznanj Ovo je dobr i stabiln Vlad zat danas misli ist to sam	sam
misli i kad smo	smo
u li u hrvatsk Vlad s HDZ om a to je da svak izlazak na prijevremen izbor koj ne nud alternativ a jamè destabilizacij demokratsk sustav nij dobr rj enj za Hrvatsk Misli da danas nij trenutk za to i da je pun prioritetn tem zavr etk proces stabilizacij Agrokor ozbiljn gospodarsk politik koj treba	treba
privuæ investicij Dakl s premijer o tom nist razgovara Nisa ta tem uopæ nij bila	bila
na stol Protekl vikend im ste	ste
nek vrst inventur u Tuheljsk toplic a staln se u oporb spominj kak se HNS izgubi u ov koalicij da æe ga HDZ proguta i da ga na izbor kad god on budu	budu
èeka crn dan Je li va doja da je HNS izgubi odluk da koalir s HDZ om Tez je potpun prom en a to potvrðuj na izborn rezulta na e èlanstv i na i rezulta u upravljanj i na lokaln i na nacionaln razin HNS je izbor svih on koj ne nasjeda na populizm neg oèekuj odgovornost i pametn javn politik I u Tuheljsk toplic je i men i cijel vodstv strank potvrðen kak su	su
na i èlanov i simpatizer prihvati odluk da izbjegn treæ izbor i stabiliziram politièk sustav Hrvatsk Ali sigurn nam neæ oprostit sporost reform i manjak rezultat ov Vlad Zat im fokus na rezulta i siguran sam	sam
da æem ga u konaènic ostvari a da æe graðan to prepozna Da se mal vratim unatrag kak je uopæ do lo do tog da se HNS odmakn od SDP a a doja je da ste	ste
jo za vrijem Tomislav Karamark stvara platform za suradnj s HDZ om Nikad to nist dokraj objasni i je li toèn da ste	ste
s Karamark razgovara o suradnj dvij strank Ta je tez kren kad sam	sam
bio	bio
izabran za predsjednik HNS a jer sam	sam
na izborn sabor reka kak je HNS graðansk centr potpun jednak udaljen i od lijev i od desn stran Jedan di novinar i javnost je zakljuèi da tu otvara moguænost suradnj s HDZ om Mi nism o tom ni razgovara s HDZ om to nij uopæ bila	bila
tem jer smo	smo
bili	bili
uvjeren da æe se vrl brz stabilizir sustav nakon pobjed na izvanredn izbor Ali i dalj stoji iz svoji rijeè da smo	smo
mi graðansk liberaln centr potpun jednak udaljen i od lijev i od desn stran i od njih æe ovisi kolik æe se nam pribl it svoj politik i kolik æe biti	biti
spremn na suradnj s nam Dakl nikakv tajn razgovor s Karamark nij bilo	bilo
Ne nij bilo	bilo
tajn razgovor jer tad nji HDZ s Karamark na èel nam nij bio	bio
prihvatljiv koalicijsk partner A kad je bio	bio
ona presudn okidaè kad ste	ste
ot li od SDP a i prista na koalicij s HDZ om U on trenutk kad je bilo	bilo
jasn da idem na treæ izbor u godin dan da bi	bi
se ponovn politik bavi sam sob umjest da se bav goruæ problem Hrvatsk od Agrokor i ugr en turistièk sezon do povlaèenj bespovratn sredstav iz EU fond to sve im izravn utjecaj na na BDP a tim i na ivot svih graðan Nitk iz opozicij nij bio	bio
spreman preuzet odgovornost za Hrvatsk veæ se svatk brin o svom imid u ne razm ljajuæ da Hrvatsk id prem nov i jo ozbiljn kriz Mi smo	smo
se tad odluèi pokaza da smo	smo
drukèij i spremn na promjen koj æe rezultir stabilizacij i odgovornost prem svoj zemlj Nedostaj li vam iz ov dan nje pozicij Vesn Pusiæ Anka Mrak Tarit i drug biv i istakn èlanov HNS a Men je ao to su	su
on ot li i vi e bih	bih
voli da su	su
danas s nam al se u tom njihov odlask otvori velik prostor za nov mlad ljud Navest æu sam nek Marij Puh Ivan Gula Dubravk Pon Oni su	su
sad potpredsjednic i istakn èlanov a da se sve to nij dogodi te ko da bi	bi
im taj politièk prostor Tak da njihov odlazak ne gleda ka nedostatk neg ka ans za nov mlad ambiciozn ljud Imat li sa svoji stari èlanov nek kontakt pozdravlja li se razgovara Da kad se sretn ljudsk razgovaram Nedavn ste	ste
govori o suradnj koj ste	ste
im s Milanoviæ i sad Plenkoviæ rekav i da je biv i premijer omoguæi veæ manevarsk prostor ministr a sad nji vol sve kontrolir Kakv je zaprav suradnj s Plenkoviæ Suradnj je zadovoljavajuæ unatoè na im razlik Povezuj nas fokus na rezulta Vlad I on i mi zna da graðan moramo	moramo
isporuèit obeæan reform Meðut umjest da se ivotn tem stavlja u prv plan sad se opet vrtim ok Istanbulsk konvencij koj sigurn neæ ni pomoæ ni odmoæ da hrvatsk graðan bolj iv Toèn to sam	sam
u vi e navrat govori i javn i með svoji èlanstv Dok je fokus javnost na Istanbulsk konvencij tem od koji graðan iv na alost pada u drug plan Na stav je uvijek bio	bio
posv jasan svi èlanov klub HNS a glasa æe za ratifikacij Konvencij uprav da bismo	bismo
tu tem zatvori i vrati u prv plan reform obrazovanj privlaèenj investicij i otvaranj novi radn mjest Misli li da ratifikacij ipak mo e zakomplicir politièk ivot i hoæ li dodatn izjav biti	biti
dovoljn da se pribl e stavov tvrð desnic u HDZ u i lijev spektr Nema nikakv problem po tom pitanj a osobn vjeruj da je i HDZ spreman biti	biti
modern europsk konzervativn strank to podrazumijev nek trend koj se i u Europ dogað kod demokr æan Je li vas HDZ il Plenkoviæ informir il ukljuèi u pisanj posebn izjav Za sad ne on zavr ava konzultacij unutar strank i oèekuj za nekolik dan taj prijedlog Ali ne nism ukljuèen u unutarstranaèk razgovor Jedan od glavn motiv da HNS uð u ov koalicij bila	bila
je br a i efikasn provedb reform obrazovanj Meðut nek vidljiv pomak jo nem Pomak itekak im a to pokazuj rezulta u ov osa mjesec kolik smo	smo
u Vlad Napravljen je dalek vi e neg to je hrvatsk obrazovanj uspjel postiæ godin prij Do li smo	smo
nadomak poèetk primjen kurikularn reform pilot faz kreæ veæ za pet mjesec U sklad s preporuk Europsk komisij usvoji smo	smo
zakon o strukovn obrazovanj svi su	su
nov kurikulum gotov revizij su	su
gotov i poèinj eksperimentaln progra na jesen Osigur smo	smo
i novc iz fond EU za provedb reform milijard kun za reform strukovn obrazovanj i 200 milijun kun za provedb kurikularn reform Uvel smo	smo
informatik ka obavezn predmet i sve nabrojen govor kolik smo	smo
posl uspjel napravi u sam osa mjesec Ali to nas neæ uspava eli nastavi tim temp Neæ li se priè o Istanbulsk konvencij gdje se vid podijeljenost hrvatsk dr tva reflektir i na reform obrazovanj kad doð osjetljiv tem i pitanj na dnevn red Reform obrazovanj temelj je i ans da Hrvatsk bud razvijen europsk zemlj pa ne oèekuj to U reform obrazovanj nem i ne smij biti	biti
ideologij Naravn da di hrvatsk dr tva el da sve ostan ist il da idem nazad i to iz partikularn a ne ideol kih interes al vjeruj da smo	smo
ka dr tvo to davn preras HNS se postavi i prem izvj æu Europsk komisij da Hrvatsk ipak nij ostvari briljantn gospodarsk rezulta o koj Vlad èest govor i da zaostaj za èlanic EU Mi to izvj æe smatram vrl ozbiljn ka konstruktivn kritik Vlad i poticaj da se svi zajedn trebamo	trebamo
usredotoèit da se reformsk proces u Hrvatsk ubrza Komisij je istakn dobr makroekonomsk pokazatelj smanjenj javn dug pa èak i rast koj je danas zadovoljavajuæ al ne pra hrvatsk potencijal Misli da Hrvatsk mo e imat rast ne od 2 8 post neg 3 5 4 4 5 post kad bismo	bismo
iskoristi sve potencijal To izvj æe nam alj poruk da je jedan di na eg posl solidn odraðen al niz drug tem ne id dovoljn brz Pohvali su	su
on to se zadnj osa mjesec dogað u obrazovanj i to je nam poticaj da ne sam u obrazovanj neg i u drug ministarstv br e nastavi s rad Znaè li ov izvj æe opomen da Vlad spor rad Djelomièn se i tak mo e zakljuèit Ali treba	treba
zna da je Vlad bila	bila
u djelomièn politièk kriz u ljet pr le godin da je Agrokor uze dost vremen i da se sad moramo	moramo
fokusir na va ne tem Ne bih	bih
reka da je rijeè o neefikasn Vlad on im vremen pokaza da mo e biti	biti
brz i efikasn Misli li da bi	bi
u Vlad treba svje e krv promjen nek ministr Ne bih	bih
se osobn reflektir na bilo	bilo
kojeg ministr a to se tiè na a dva ministr potpredsjednik Predrag tromar i ministric Bla enk Divjak tu ne treba	treba
nikakv svje e krv jer su	su
on pokaza da odlièn rad Kak procjenjuj final ok Agrokor Oèekuj da æe do nagodb doæ do ljet ov godin a va no je da nastav ne sam sustav Agrokor s rad neg i svi on dobavljaè proizvoðaè koj su	su
bili	bili
dobri dijel naslonjen na taj sustav elj mi je da nagodb rezultir srednjoroèn odr iv plan poslovanj i zadr avanj radn mjest i proizvodnj Jeste	jeste
li ka jedan od kljuèn ljud u Milanoviæev Vlad zna da se bli i kriz takv razmjer u Agrokor Do men nis dolazi takv informacij Zna se da su	su
dost zad en al u vrijem Milanoviæev Vlad nij bilo	bilo
nikakv problem u financiranj sustav Nisa zat uopæ mog predvidjet to æe slijedi Hrvatsk je pred velik projekt izgradnj Pelj kog most a postoj sumnj da su	su
Kinez koj æe najvjerojatn gradi most dal prenisk cijen koj je nerealn Mo e li to stvori nov problem to bi	bi
se mogl reflektir i na ov Vlad Ne vidi da æe tu doæ do problem Bio	bio
je javn natjeè sad dr avn komisij za javn nabav odluèuj o zakonitost sam natjeèaj i nakon don enj odluk oèekuj realizacij projekt Sve firm koj su	su
se javi daj sigurnost da æe posa biti	biti
obavljen a ne sumnja tak ni da Kinez ne bi	bi
zavr il taj posa Ne oèekuj nikakv problem Postoj jo nekolik kritièn toèak za hrvatsk gospodarstv kriz u Uljanik Petrokemij 3 maj To su	su
tem o koj se do sad nij dovoljn raspravlja u javnost Cijel brodograðevn sektor mora	mora
dobi od Vlad model financiranj jer ne postoj uspj na brodogradnj u svijet koj nij podr an od razvojn bank i fond Imam i otvoren tem Petrokemij koj se treba	treba
u sljedeæ nekolik mjesec zavr it ulask stra kih partner i nastavk proizvodnj Oèekuj da æe sljedeæ nekolik mjesec to biti	biti
u fokus javnost i rad Vlad a tu vidi i vrl aktivn ulog HNS a Doja je da smo	smo
osta po stran i kod buduæ pravc dostav plin Hoæ li to imat posljedic za Hrvatsk Nema mi taj problem Danas im ok 50 post svoj proizvodnj plin to je na alost u pad al za nekolik mjesec slijed drug krug natjeèaj za istr ivanj i eksploatacij to bi	bi
treba kroz nekolik godin poveæat proizvodnj Imam pred sob realizacij projekt LNG a na Krk i to se tiè energetsk sigurnost i konkurencij kad je rijeè o cijen ne predvið nek velik problem Dug ste	ste
suraðiva sa SDP om kak ocjenjuj sad nje stanj u toj stranc pogotov kritik da je dan nja oporb u Sabor nevidljiv Misli da je èak i vidljiv al upitn je na koji tem Danas je u Sabor dominantn pravi predstav i dezavuir sam institucij parlament a ne potica pozitivn dijalog Iskren se nada da æe se to popravi i da æe se SDP konsolidir jer jak SDP je potreban Hrvatsk Misli da se SDP mo e konsolidir s Davor Bernardiæ na èel Ne voli se bavi tuð strank jer svak trenutk korist da se bav problem graðan rad Vlad svoj strank suradnik èlanstv Nis predsjednièk izbor bliz al se veæ o njim govor Hoæ li HNS podr at predsjednic Kolind Grabar Kitaroviæ ak se odluè na drug manda il æe imat svog kandidat Izbor predsjednik dr av va no je politièk pitanj o koj u HNS u vodi raèun al danas nam to nij prioritetn tem Sad su	su
nam u fokus mjer i rezulta ov Vlad Nedavn je zavr il s rad Povjerenstv za pr lost al rezulta ba nis bajn Te ko da æe tak formuliran stavov moæ biti	biti
pretoèen u zakon pa kakav je stav HNS a o ustavnost il neustavnost ust kog pozdrav Za dom spremn Mi smo	smo
prij pol godin priè o tom da nam je potrebn povjerenstv za suoèavanj s buduænost a ne pr lost Ali po tuj i povjerenstv koj je pok al dat nek svoj okvir kak gleda na nek povijesn tem Ono to je svim u Hrvatsk ne sam nam u HNS u bitn jest da svak rj enj mora	mora
biti	biti
sukladn Ustav i na tom æem inzistir Znaè li to da neæet podr at stav Povjerenstv da nek iznimk mogu	mogu
postoja Izuzec od Ustav otvaraj Pandorin kutij koj nik ne treba	treba
Tad bi	bi
se na lo niz drug tem i argument da se izuzm iz ustavnost To nitk ne el Hrvatsk se sve vi e susreæ s populizm i populistièk strank Kolik to mo e ugrozit politièk sustav Tu Hrvatsk nij ni ta drugaèij od drug europsk zemalj Populizm se prv poèe pojavljiva na desn spektr i dogodi se da ljevic u svom odgovor od u lijev populizm HNS je izbor svih on koj ne nasjeda na populizm neg oèekuj odgovornost i pametn javn politik Pred nam je vrijem da se jasn artikulir da anarhist koji im i u hrvatsk politic mogu	mogu
na ne to ukaziva al ne daj i rj enj A mi trebamo	trebamo
rj enj a ne jeftin populizm Bulj vas je prij nekolik dan o tr kritizir Imaj li te kritik pokriæ Pametn i ozbiljn ljud bav se sob i svoji idej i rezultat Oni drug nesposobn uglavn se bav drug politièar Rast popularnost iv zid Most je tu hoæ li se trend njihov popularnost nastavi da se poremet arhitektur na hrvatsk politièk scen Vi e od ov ne oèekuj Prij sveg zbog tog to oèekuj da æe ov Vlad dat rezulta i dokaz kak ozbiljn politik treba	treba
vodi zemlj Jutarnj listCopyright HANZA MEDIA d o o Sva prav pridr an IzdvajamoNajèitanijeIz drug medij Na zagrebaèk Trg ban Jelaèiæ u nedjelj poslijepodn policij je provel ops no postupanj protiv kak se èin pripadnik navijaèk skupin Varvar koj je u hrvatsk metropol do la dat podr ku crnogorsk ko ark kom klub Buduænost koj im zakazan susret s domaæ Cedevit Policijsk su	su
slu benic postroji nekolik desetk mu karc uz jedn od zgrad na Jelaèiæev trg natjerav i ih da se lic okren prem zgrad te da podign ruk u vis i naslon ih na zid Nakon tog uslijedi je detaljan pregled svak od njih U blizin skupin vidljiv je vi e razbijen boc i porazbacan predmet to sugerir da je prij policijsk postupanj do lo do nek nasiln incident no zasad nij potvrðen to se toèn dogodi iak se spominj razbijanj kontejner u obl njim ulic te provociranj sluèajn prolaznik HRT javlj da su	su
ulic navodn uzvikiva Ovo je Srbij U svak sluè policijsk je intervencij osujeti dodatn nemi dogaðaj Jutarnj list Copyright HANZA MEDIA d o o Sva prav pridr an ELIPSO Izdvaja Najèitanij Djeèak 13 nesta je u subot ok 15 sat kad se prevrn èamc na rijec Uni kod Nov Grad u BiH	bih
U njem je bio	bio
s dvij odras osob koj su	su
uspjel ispliva te su	su
na sigurn Hitn slu be BiH	bih
odma su	su
zatr il pomoæ od hrvatsk slu be 112 jer postoj moguænost da je djeèak ispliva na hrvatsk stran Une Na centr 112 alarmir je nas i mi smo	smo
na teren od juèer u 16 30 sat doznajem od Tomislav Bogojeviæ proèelnik HGSS a Stanic Novsk HGSS ovc iz Stanic Novsk njih 23 s tr ronioc i èetir èamc odma su	su
pregleda teren kod Dvor na Uni no kak je pal noæ s potrag se kren u nedjelj ran ujutr Pretr uj korit rijek Une i oba na hrvatsk stran S drug bosansk stran Une u potrag je ukljuèen vi e desetk vatrogasc i policajc Jutarnj list Copyright HANZA MEDIA d o o Sva prav pridr an ELIPSO Izdvaja Najèitanij Sisaèk biskup Vlad Ko iæ predvodi je na Nedjelj muk Gospodnj Cvjetnic u katedra Uzvi enj svet Kr a u Sisk sveèan misn slavlj koj je prethodi blagoslov maslinov granèic i procesij kroz Gradsk park ka spomen Isusov ulask u Jeruzalem Biskup je upozori kak se i danas Krist razapinj kad se pon av vrijeð i progon Crkv Na a Vlad i predsjednik i ministr svoji prihvaæanj Istanbulsk konvencij pljun su	su
nam katolic u lic al jo postoj i na i narodn zastupnic u Hrvatsk sabor koj ne smij ak su	su
vjernic dat svoj glas za tu ratifikacij Ne smij to ni on koj su	su
nevjernic zbog pravn i moraln razlog i zat to bi	bi
se tim prihvati nadzakon koj bi	bi
nadzir domaæ zakon A rad se o dubok nekr æansk zakon i kak je reka predsjednik HBK on koj to zlo podupir sam seb ekskomuniciraj iz Katolièk crkv Moli se braæ i sestr i dalj da to zlo ne prevlad zakljuèi je biskup Jutarnj list Copyright HANZA MEDIA d o o Sva prav pridr an ELIPSO Izdvaja Najèitanij Nekad nji saborsk zastupnik i dugogod nji glavn tajnik kljuèn operativc i jedan od osnivaè Hrvatsk strank prav Ante Starèeviæ HSP AS Per Æoriæ iskljuèen je iz èlanstv te strank objavljen je u nedjelj u priopæenj koj je potpisa predsjednik HSP AS Hrvoj Niè U priopæenj se navod da je u subot stranaèk predsjedn tvo u Zagreb raspravlja o refinanciranj dug a da je Æoriæ otvoren prizna kak je sabotir rad Predsjedn tva U nastavk donosi cijel priopæenj u kojem se iznos te ke opt be na Æoriæev raèun Hrvatsk strank prav dr Ante Starèeviæ odr al je 24 03 2018 sjednic Predsjedn tva u Zagreb na koj je kljuèn bila	bila
toèk don enj odluk o naèin refinanciranj dug po nastali obvez iz razdoblj 2014 2017 Tijek rasprav glavn tajnik strank Per Æoriæ otvoren je prizna kak je sabotir rad Predsjedn tva izmeð ostalog pok avajuæ osigur nedostatk kvorum a ist je u jedn trenutk i pok ao osobn sr it svoji odlask sa sjednic Predsjedn tva prit kazav i kak je on osnova strank te æe je on i ugasi Ponovn osiguravanj kvorum Predsjedn tvo je jednoglasn usvoji sve predl en odluk s cilj financijsk stabilizacij strank Tijek sjednic Predsjedn tva dopredsjednik strank Ante on Maksan Èasn sud strank na razin RH uputi je prijav protiv glavn tajnik Per Æoriæ s prijedlog za iskljuèivanj iz HSP AS zbog kr enj Etièk kodeks strank i priznavanj otvoren rad protivn odluk Predsjedn tva strank Èasn sud je uv io prijav te iskljuèi Per Æoriæ iz HSP AS Usvojen odluk i iskljuèivanj Per Æoriæ iz HSP AS Predsjedn tvo strank je odluèi poslat jasn i nedvosmislen poruk kak se sve stranaèk odluk moraju	moraju
donosi jedin i iskljuèiv na stranaèk tijel a ne ka je to nerijetk bio	bio
sluè put izjav pojedinc u medij zbog èeg su	su
nar en brojn odnos s nekad njim i postojeæ koalicijsk partner na svim razin vlast al je i nar en vjerodostojnost i ugled HSP AS með èlanstv i simpatizer Predsjedn tvo je ist tak pokaza odluènost u namjer da rij i problem koj strank vuè jo od vremen parlamentarn izbor iz 2011 godin Svoji rad djelovanj i javn prezentacij HSP AS mora	mora
biti	biti
stup prav tva s obzir kak je rijeè o logistièk i po broj vijeænièk mandat najsn nij prav koj stranc u RH te kak prav ka idej mora	mora
biti	biti
iznad interes pojedinc to èest do sad nij bio	bio
sluè Jutarnj list Copyright HANZA MEDIA d o o Sva prav pridr an ELIPSO Izdvaja Najèitanij Ante Biuk iz Ogorj koj je prij tjedan dan u ao u Big Brother nakon èeg su	su
medij odma izvijesti da je rijeè o osob s ozbiljn pravosudn problem izbaèen je iz RTL ov reality show u nedjelj Produkcij projekt Big Brother odluèi je izbaci stanar Antu Biuk iz kuæ javi je RTL navodeæ da je Biuk kuæ napusti u 13 sat Biuk su	su
izbaci dan nakon to je usred prijenos u iv jedn od sustanar reka da je svojedobn jedn en pretuka nog tak da joj je izbi kamenc iz bubreg te da je to zasl il Nakon izjav o fizièk nasilj nad en Big Brother je pozva g Biuk u ispovjedaonic i upita o navod na to je naveden stanar odgovori negiranj Pravi kuæ zabranjuj laganj u ispovjedaonic Izjav o povred en su	su
neprihvatljiv a RTL najstr e osuðuj svak vid nasilj te su	su
navod biv eg stanar predan policij navod se na RTL ov stranic Iak je Biuk izbaèen tek nakon izjav o nasilj èim je u ao u kuæ na vidjel su	su
iz li njegov problem sa zakon Tak je Slobodn Dalmacij detaljn izvijesti da je 41 god njak formaln pravn neosuðivan al se protiv njeg primjeric vodi postupak bog sudjelovanj u tuènjav iz 1996 a koj je zavr il smræ britansk vojnik unproforc Simon Leej Terence Jeans Taj je postupak okonèan 2000 godin zbog zastar al prij tog Biuk je nepravomoæn presud dobi 6 mjesec zatvor Najnov problem sa zakon Biuk je im net prij ulask u kuæ Objavljen je naim da je tjedan dan prij ulask u show navodn do ao 84 god njem susjed s pu kom M48 na kuæn vrat u Ogorj Donj nakon èeg mu je navodn ukra tisuæ eur tisuæ kun i zraèn pu ku Istrag protiv njeg za ov djel je otvoren al jo nij pravomoæn Bud li mu u konaènic suðen prijet mu kazn od 3 do 12 godin zatvor Jutarnj list Copyright HANZA MEDIA d o o Sva prav pridr an ELIPSO Izdvaja Najèitanij Doæ do Dank Konèar da bi	bi
da intervj a intervju daj sve rjeð i rjeð gotov je nemoguæ misij Hrvatsk poduzetnik i vlasnik Kermas grup pod èij kap je i Brodotrogir te potencijaln najveæ europsk brodograditelj danas je u Afric sutr u Kin prekosutr u Tursk Taj 75 god njak koj zbog interes za Uljanik finsk brodogradi tem Arctech te problem u Brodotrogir ponovn pun medijsk prostor praktièk iv u avion I ne staj tov e ne misl da je preaktivn neg da nij dovoljn aktivn No na i tjedn pok aj i èekanj su	su
se isplati Uhvati smo	smo
ga dod e na Skype u sitn noæn sat u hotelsk sob u Hong Kong al u najbolj trenutk u petk na dan kad se zatvara dat ro za Uljanik Ova petk je isteka rok za preda ponud za Uljanik Jeste	jeste
li preda ponud Kermas energij je preda obvezujuæ ponud za stra ko partnerstv u transformacij Uljanik grup i 3 maj te u daljnj razrad Program restrukturiranj Uljanik brodogradi ta u suradnj s Republik Hrvatsk Postanet li vlasnik Uljanik grup hoæet li osta sam na brodogradnj il planir diverzificir poslovanj ka kod Brodotrogir Razv novi djelatnost predvidjel su	su
sad nji vlasnik i Uprav Uljanik grup Dapaè naveden je u poziv potencijaln partner Pojasn nam mal svoj poslovn logik Europ je brodogradnj prepusti na milost i nemilost tr i tu i mal je br brodogradi ta koj su	su
pr ivjel Ona koj jesu	jesu
te ko mogu	mogu
konkurir dalekoistoèn brodogradi tim A vi ste	ste
s drug stran nakon Brodotrogir dal ponud za Uljanik i 3 maj a jo preuzima i finsk brodogradi te Arctech Koj je va a motivacij Misli da je rj enj cijel hrvatsk brodogradnj ka i europsk brodogradnj u integracij specijalizacij i racionalizacij Ono to treba	treba
staln imat na um jest da ni Hrvatsk nit Europ nema dovoljn visok specijaliziran radnik koj æe radi u brodogradnj Hrvatsk i europsk brodogradi ta na dan nji dan uvoz radn snag Brodogradnj nij djelatnost za koj se radnic otima to su	su
ekstremn te ki poslov No manjak radn snag uprav vod prem ovom integracij specijalizacij i racionalizacij U svak sluè ne smij se radi na proizvodnj rad sam proizvodnj Ona ne mo e sam seb biti	biti
svrh neg mora	mora
biti	biti
podl na tr i tu to mo et ponudi svjetsk tr i tu i naruèitelj brod u odnos na Kinez i Ju nokoreanc U Kin i u Ju noj Korej se rad masovn proizvodnj jedn te ist brod i tu smo	smo
mi dalek iz njih iz jednostavn razlog Prv novc je u Kin gotov besplatn Drug cijen limov je dalek ispod on cijen koj Europ plaæ Mora	mora
se stog iæ u smjer gdje se prodaj pamet u smjer gdje se rad sofisticiran brod u jedan dva primjerk i to dok Dalek istok nij iskopir te tipov brod i poèe njihov masovn proizvodnj S drug stran veæin brodogradi ta u Ju noj Korej stvar gubitk al je dr av sta iz njih i pom e im na razn naèin kak bi	bi
nastavi svoj djelatnost Usred odbrojavanj dan do predaj ponud pojavi su	su
se spekulacij da je talijansk brodograðevn korporacij Fincantier zainteresiran za Uljanik Jesu	jesu
li va a vrat mo da otvoren za potencijaln partner Apsolutn al na ravnopravn osnov i da se zadovolj obostran interes I u Fincantierij postoj manjak radn snag pa tak èak uvoz radn snag s Dalek istok jer je on mnog jeftin od europsk Sigurn da je moguæ suradnj pod uvjet da se sjedn i razgovar i da se jedn i drug interes stav na stol te obostran pok aj zadovoljit Ka u da je uspj an biznis umjetnost kompromis Arctech primjeric nij do ao u Brodotrogir odradi ne to to je mog kod seb Do ao je ba zat to nij mog kod seb pa je tr io nek drug tko to mo e Nij da sam Brodotrogir to mo e al njeg je izabra ka partner u tom posl Kad smo	smo
kod Arctech kak se razvij situacij s preuzimanj tog finsk brodogradi ta Kad oèekuj finalizacij U sljedeæ tjedn im zavr ne razgovor Jasn je potreb i to prvenstven Arctech da se osamosta odnosn da se udr i s nek europsk brodogradi tim koj mogu	mogu
zajedn napravi sofisticiran tipov brod I ne treba	treba
zaboravi jedn èinjenic Arctech je od ukupn dan nje aktivn arktièk flot u svijet sagradi njih 60 post Dakl im savr en tehnièk rj enj S drug stran Rusij je odluèi napravi sjevern pomorsk put plovn i treba	treba
imat na um da taj pravc dramatièn smanjuj vrijem transport iz recim Japan u Rotterda To je prilik za Arctech i brodogradi ta koj su	su
njegov partner Prozvan ste	ste
Putinov èovjek jer kupuj to brodogradi te od Rus Kad sam	sam
do ao u Ju nu Afrik tam je takoðer bilo	bilo
nemoguæ prihvatit da je jedan èovjek iz nek njim nepozna zemlj za koj nikad nis èul do ao i kupi najveæ rudnik krom na svijet I odma su	su
me proglasi Rus i govori da iz men stoj rusk kapita Danas u industrij krom bilo	bilo
to u Ju noj Afric Kin il bilo	bilo
gdje drugdj svi zna moj im i svi zna da sam	sam
iz Hrvatsk Rusij se vi e ne spominj odavn a kad se priè o men govor se o èovjek koj rad 24 7 i vlastiti snag razvij biznis Kad ljud nema odgovor ond su	su
sklon etiketiranj Prij sveg tit svoj interes Zaprav ne ba uvijek Ponekad se upuca u nog Kod Arctech vidi ans za Brodotrogir njegov iskorak u proizvodnj visokokvalitetn tehnologij u brodogradnj To Brodotrogir trenutn nedostaj No valjd vrijed on ak ne mo e nek pobijedi ond mu se pridr i Tu vidi ans ne sam za Brodotrogir neg i za Uljanik grup No kad smo	smo
kod preuzimanj Arctech moram	moram
reæ da uopæ nij predviðen da ga kupi od Rus neg æe Arctech izda nov dionic koj æe prijeæ u na e vlasn tvo Va novinarsk kruh nij ba jednostavn I ponekad pojedinc zastran poved se za on to zvuè atraktivn od istin pa na kraj budu	budu
objavljen svakojak bedastoæ i neistin konstrukcij Sigurn je da sam	sam
i ja grij io i da mi se mo e sva ta prigovori no ponekad se stvarn pretjer Zar bih	bih
ja bio	bio
astronaut sam zat to je to netk objavi u novin Arctech je usosi i Brodotrogir Plaæ kasn najavljuj se 300 otkaz Kakav rasplet situacij mo em oèekiva Arctech koj se i sam	sam
bor s financijsk pot koæ s koji smo	smo
se dogovori da nas mjeseèn plaæ veæ dva mjesec nij plati ni ta Trenutaèn je posa s Arctech jedin koj se u odvij u trogirsk kver Konaèn plaæen je jedan mal di Arctechov dug novc je na raèun HBOR a i vjerojatn æe biti	biti
pu ten u ponedjeljak Bez obzir na to ka njenj plaæ radnik isplaæen su	su
i to tak da su	su
prebaèen s raèun vlasnik S obzir na trenutaèn poslovanj prav je èud da je Brodotrogir isplati plaæ za prv mjesec i sad za drug mjesec Do ov trenutk prek Kermas energij i nek drug tvrtk u na oj grupacij u Brodotrogir je u lo vi e od 60 milijun eur Rekl ste	ste
u nek svoji ran intervju da ste	ste
ulask u priè s brodogradi tim de fact pomogl Hrvatsk da zatvor poglavlj ok ulask u EU i da je to na poèetk bila	bila
praktièk uslug Hrvatsk Nij li ta uslug ipak mal preskup Moram	moram
prizna da u tom bilo	bilo
pun istin prij pet godin jer su	su
na kraj apelir na moj domoljublj U igr su	su
bila	bila
èetir kver al ond je priè zavr il sam na jedn Brodotrogir Sad kad se okren Vlad mi je napravi uslug Nastoja sam	sam
dokaza da nisa do ao un tit kver jer nik ne eli lo e a pogotov nisa eli Brodotrogir Tek danas to ne eli i bori se na dnevn baz da Brodotrogir saèuva brodograðevn djelatnost to je s investicij u Brodotrogir Ugovor o privatizacij bila	bila
su	su
predviðen visok ulaganj vi e od pol milijard kun a realiziran je pol To je istin no treba	treba
uzet u obzir da su	su
nek investicij u tijek posebn u marin a on su	su
povezan s pribavljanj potrebn dozvol i koncesij to naravn ne ovis o nam No kad se pogled drug kriterij a to je vlastit doprinos ond je brojk i prem en A gdje je taj novc Preli se u plaæ osobn dohotk koj nis zaraðen Primjeric prij privatizacij za gradnj jedn kemijsk tanker a Brodotrogir ih je sagradi vi e od 50 u svoj povijest bilo	bilo
je potrebn devet mjesec Nakon privatizacij za gradnj ist brod a financijsk sredstv su	su
bila	bila
osiguran u cijelost bilo	bilo
je potrebn 18 mjesec Na gradnj brod u koj je ugovoren sam rad za 15 milijun dolar Brodotrogir je izgubi 6 7 milijun Na tom brod figurativn reèen bilo	bilo
je predviðen 100 000 sat rad na jedn segment a na kraj je ispa da se radi 400 000 sat Zat govori da sindikat mora	mora
biti	biti
partner Sindikat je nu na organizacij unutar dr tva al mora	mora
pomaga i u realizacij jer je na kraj interes vlasnik i radnik koj on zastupa identièan Mo e li uopæ brodogradnj posta odr iv Kak postavi financiranj poslov pogotov u svjetl aktualn situacij i problem u Uljanik zbog kojeg su	su
bank postavi regulatorn limi i dodatn za trava uvjet kreditiranj U svim europsk dr av postoj agencij koj izda kreditn jamstv npr Finnver Atradius il Cofac Oni procjenjuj i pokriva stvarn rizik posl i za to su	su
specijaliziran Na osnov njihov polic poslovn bank lak e izda kredi i financiraj nov projekt Ovakv institucij su	su
profitn i osi omoguæavanj posl drug i sam stvaraj profit Rj enj za Hrvatsk je pun integracij i preuzimanj najbolj europsk praks a spomenut agencij uprav su	su
to Sla et li se s tvrdnj da je hrvatsk brodogradnj u stanj kakv jest uprav zbog dr avn intervencij Èinjenic je da je pun novc upucan a brodogradi ta nis uspjel posta konkurentn Postoj jedn svijest jedn prom ljanj kod ljud kad je o privatizacij rijeè kverov je uglavn privatizir dr av a sad kad doð netk drug javlj se jedn gorèin Na e dr tvo mora	mora
pronaæ naèin kak da to prevazið za to je potreban ogroman rad Netk je do ao sa stvarn novc koj je negdj zaradi i ne to je stavi u funkcij Ako pogleda Brodotrogir taj proces je jo uvijek u tijek odnosn pun novc je ul en u taj proces no on jo nij dovr en Pojasn nam to mal to èek ljud U Brodotrogir smo	smo
napravi velik gr ku Ugovor o privatizacij je predvið da Brodotrogir im 700 zaposlen ljud a danas ih im 1079 Kad govori da æem br zaposlenik smanjit za 350 opet dolazim na 29 ljud vi e od 700 kver nem izbor Postoj sam pitanj hoæ li se saèuva kver odnosn brodograðevn djelatnost il neæ Ako eli saèuva brodogradnj ond se kver mora	mora
prestroji Pojedinc ukljuèujuæ men sam nij va an Va an je kolektiv va no je odr avanj brodogradnj To je jedin cilj koj im Ako im vi ka ljud tj vi ka nek funkcij ond treba	treba
te funkcij ukin i ljud zahvali na ona naèin koj predvið kolektivn ugovor Tragedij Brodotrogir a za to nis radnic kriv jest to to je stimulacij svak mjesec svak radnik gotov ist a svi zna da nij tak i da im ljud koj zab ava dok nek drug rad vi e Ta æe se situacij u Brodotrogir ra èistit on æe doæ na svoj zat to je su	su
tin Brodotrogir da im posl svak dan Ako 300 ljud od iz Brodotrogir ak postanet vlasnik Uljanik i 3 maj i on pr iv ist sudbin bit æet najomr en èovjek u dr av Da bi	bi
bio	bio
uspj an ka tvrtk mora	mora
procijeni nekolik stvar Prv jesu	jesu
li ti sve funkcij na koj ljud rad potrebn Ako jest dobr al ak nis mora æe u jedn trenutk rij it problem Jer ak iz kver ne od on koj nis stvarn potrebn mogl bi	bi
se dogodi da u jedn trenutk svi moraju	moraju
kuæ Imam situacij u Brodotrogir gdje jedan poslovoð koj ni ta ne rad im pod sob jedn jedin radnik Ba me zan to on rad To nij normaln Ljud se ne treba	treba
baca na ulic Treba	treba
im naæ drug zanimanj i drug poslov Mora	mora
postoja odgovornost i on se mora	mora
preuzet U hrvatsk brodograðevn industrij kraj 90 ih radi je pet put vi e ljud neg danas Tih 80 post koj su	su
ot li na li su	su
nov posa Danas u Hrvatsk im situacij da nem ljud za pojedin djelatnost a u drug postoj manjk Rj enj je dakl u preraspodjel fluktuacij radn snag Apsurdn je da iz Hrvatsk odlaz najkvalitetn radn snag To je iron mnog industrij vi ak radnik a manjak on koj trebaju	trebaju
Mora	mora
biti	biti
nek socijaln konotacij sveg to se rad I dr tvo mora	mora
preuzet di te korekcij na seb Brodogradnj staln uz novc a im i podatk da je Uljanik dobi stotin milijun eur garancij al to je bila	bila
nu nost Jedan zaposlen u brodogradnj hran mnog ust jer brodogradnj stvar radn mjest i u drug industrij Mi i danas uvozim specijaliziran radn snag brodogradnj ih uvoz Nek æe ljud na kraj mora otiæ to je nu nost no nitk neæ biti	biti
izbaèen na cest Bi	bi
li bili	bili
tak benevolentn nje ni i drag da se rad o va im drug firm u Ju noj Afric Tursk il u nek drug zemlj Svak se dr tvo razlikuj i svugdj se bori na razn naèin Imal smo	smo
jedan prilièn grub trajk u Tursk koj je na kraj zavr io pogubn i za tvrtk i za sindikat Bilo	bilo
je grubi nastup pojedinc su	su
tukl svoj prijatelj i koleg To je problem grupn razm ljanj u koj ak nis èlan treba	treba
te odstrani Jeste	jeste
li se sad spremn bori i to ne sam u Brodotrogir Postanet li vlasnik Uljanik mo da vas oèekuj ist situacij Borb je moj permanentn stanj Kad pogleda sve ok men sve je to borb Uzmi sam primjer projekt Svet Katarin Monument Treba nam je seda godin borb da doðem do potrebn papir I danas sve nij èist i jasn Nedavn smo	smo
na li i bomb na tom podruèj Jednostavn bijel mi ev izvir tam gdje ih nikad nis oèekiva Proziva vas da se fokusir sam na mjest koj mogu	mogu
biti	biti
potencijaln turistièk atraktivn za marin Ja im tu jedan drug pogled Nebitn je tko je vlasnik Bitn je ne to to je zap ten ka recim Svet Katarin Monument stavi u funkcij Na Katarin æem u dogovor sa zagrebaèk HNK kraj lipnj napravi jedan balet na otvoren jer eli dovest kulturn element na to podruèj Rad se pun par im lud plan da jedan mal di marin otvori veæ ov godin sam nekolik mjesec od poèetk rad Bit æe ukupn 65 milijun eur investicij jedan hotel u dvij zgrad bit æe 1500 vezov u mor i suh marin remont i mnog drug sadr aj uobièajen za marin Umjest vojsk koj je oduvijek bila	bila
tam sad æe Pul dobi jedn ozbiljn dodan vrijednost u turistièk smisl Transformir sad devastiran prostor iz nièeg u ne to vrijedn to je bitan element A vlasn tvo Ako si	si
uspj an pa ne to zarad u red Ali recim to ak ka u Brodotrogir ne mo e zaradi ni ta Sjeæ se jedn natpis u jedn pogon u 3 maj na koj su	su
radnic napisa da je Vlad donijel odluk da prod brodogradi te za jedn kun I ond uz to natpis zar mi vrijedi sam jedn kun To demonstrir totaln nepoznavanj situacij Mi nism kupova radnik Mi smo	smo
preuzel obavez da ih hran Tko god u Hrvatsk hran veæ br ljud zna o èem priè Ti svak mjesec mora	mora
namakn da isplat plaæ i vjerujt mi u toj situacij men je i ta jedn kun bitn Da èinjenic jest da brodogradnj nij nek privlaèn gran Jedn tr e partner drug jamstv a i veæ je br on koj su	su
se na brodogradnj napati neg obogati Prevladav mi ljenj da ste	ste
potpun lud to se u to uopæ up tat Èest i men padn na pamet da se sam potpun lud èovjek mo e upustit u ovak ne to A ak se ne vara svojedobn ste	ste
rekl da ste	ste
u li u brodogradnj sluèajn To je zanimljiv jer su	su
vas hrvatsk medij veæ prozva kralj krom sad vas zov kralj europsk brodogradi ta Kad biste	biste
uz Brodotrogir posta jo i vlasnik Arctech 3 maj i Uljanik im biste	biste
vi e od est tisuæ zaposlen i bili	bili
biste	biste
jedan od najveæ europsk brodograditelj Ja nikad nisa ni sanja brodogradnj ni Brodotrogir ni udr en hrvatsk i europsk brodogradnj Mi i danas im jedan mal postotk dionic u Uljanik grup Dakl ja ne vjeruj da vlasn tvo u brodogradnj rj av bilo	bilo
to Jer èeg si	si
vlasnik Uzmi Brodotrogir primjeric Vlasnik zemlj i svih zgrad na toj zemlj je dr av Vlasnik si	si
pokojeg stroj i im obavez hrani ljud koj tam rad To su	su
ljudsk sudbin Te ko je tu obavez ispunjava i staln se pit jesi	jesi
li il nis u moguænost Staln si	si
u preispitivanj Spomen ste	ste
Sv Katarin Monument Prij par mjesec dobi ste	ste
odobrenj za preuzimanj Apartman Meden Kak ste	ste
zadovoljn razvoj drug turistièk projekt Meden i apartman Meden u Trogir to je nekad bila	bila
jedn firm i iz men nepoznat razlog razdvojen je Mi ih eli spoji ka nekad Takv nov Meden im golem turistièk potencijal za razv na toj jedinstven lokacij Veæ dvij godin zared Meden pozitivn posluj i na to sam	sam
osobit ponosan Iak nism gradsk hotel mi radi cijel godin Vratim se mal na Finsk u koj se zaprav sva ta dogað Ime vam se provlaè kroz Rajsk papir koj su	su
otkri tajn porezn oaz Rajsk se papir odnos prvenstven na Panam no u tim se papir spominj sva ta od englesk kraljic pa nadalj Pa to je fin dr tvo u koj ste	ste
se na li Da ne bi	bi
nastavi financiranj svoji kolon ka to su	su
Djevièansk otoc il Baham pametn Englez su	su
smisli porezn oaz koj se sam financiraj Nij to od juèer to je izm ljen davn To su	su
svi prakticir ukljuèujuæ englesk kraljic Kermas je mora posta europsk grupacij i mora smo	smo
ga preseli na Malt te smo	smo
od tam kren razvija holding èij su	su
sve tvrtk kæer danas europsk tvrtk Sve koj smo	smo
nekad im po tim egzotièn otoc odavn su	su
zatvoren Papir su	su
otkri va jak utjecaj u grupacij Afarak Finsk financijsk nadzorn tijel vas proziv zbog nedozvoljen kontrol nad Afarak tr e objav javn ponud prijet penal Kakav bi	bi
epilog mogl dobi cijel ta situacij Finsk nadzorn tijel donijel je odluk bez ijedn dokaz Kad je sve poèel tr io sam	sam
da mi preved papir al su	su
odbi Zar ja nema prav na obran To prav mi je uskraæen Ima sam	sam
oslobaðajuæ presud u ist sluè koj je izda dr avn tu itelj al ta presud finsk nadzorn agencij ne vrijed Osnovn je problem u tom to æe se to vuæ godin to nij dobr u dan njoj atmosfer kad bank postr uj uvjet Na kraj vas pita tko bi	bi
mog osjeti posljedic tih neprestan udarc prem kompanij Pa jasn svi njezin dionièar I mal i velik Pojedinc propituj i ulog europarlamentarc Ivan Jakovèiæ koj je u Nadzorn odbor finsk grupacij Afarak njegov potencijaln sukob interes povezanost s Rus Postoj odreðen minorn snag u Istr koj su	su
iskoristi ov problematik s Uljanik i prisjeti su	su
se star idej Jakovèiæ od prij pun godin kad je predlaga da se Uljanik presel sa sad nje pozicij i da se Pul naprav sred tem nautièk turizm Jedn idej vrijedn pozornost to je istin no u to vrijem mal preuranjen jer nij bilo	bilo
uvjet Uljanik nij poja sam za ljud iz Istr I men je poja On im golem znaèenj za hrvatsk brodogradnj al i mnog ir No do lo je do zastoj jer u brodogradnj treba	treba
permanentn ulaga No za to je uopæ Jakovèiæ ang iran u Afarak Kak pridonos kompanij Ipak je vi e usmjeren na turizm neg na talionic i rudnik Jakovèiæ je danas èlan Nadzorn odbor u Afarak i moram	moram
prizna to uopæ nij bio	bio
moj prijedlog al nisa ni im ni ta protiv da uð Jasn je da je Afarak koj je ekskluzivn bio	bio
lociran u Afric Tursk itd od interes da im u NO u èovjek koj je u sr i Europ Misli da je 90 post parlamentarc EU u jedn il vi e poduzeæ u NO u No u Hrvatsk je sve to problem Jasn pok ava to shvatit i misli da se na i ljud uznemir kad èuj ne to tak jer nikad dosad nis im prilik vidjet da je to uobièajen praks u Europ Kad smo	smo
kod domaæ ljud Iva Majol je opet u problem to se to dogað Za to ste	ste
joj pomogl Voli tenis il Ona je prijateljic moj kæer i jasn da je to tu na priè u koj je netk ka svjetsk im a Iva jest do ao u nek financijsk pot koæ Jedin to sam	sam
ja napravi jest to sam	sam
preuze dug od bank i sad on im obavez prem men s tim da je ja ne tjera a bank bi	bi
je tjera da to to prij vra Sudeæ po svem i aktualn oping i irin poslov koj su	su
na razn kontinent preaktivn Sigurn sam	sam
da bi	bi
se va a suprug sa mnom slo il Planir li ikad u mirovin To je pitanj na koj æe odgovori ivot Imam prev e trenutaèn problem i stvar koj moram	moram
rij it a to mogu	mogu
jedin ak sam	sam
aktivn Mo da bih	bih
mog i vi e Stog mirovin zvuè ka dalek buduænost Jutarnj list Copyright HANZA MEDIA d o o Sva prav pridr an ELIPSO Izdvaja Najèitanij Bob Jelèiæ im nov predstav Zov se Govor glasn U njoj ka i inaè èeprk po ljud a ov put to èin u Kerempuh U Govor glasn svoj lik pri æe kontekst koj svi el potisn ka i svak lo e sjeæanj rat A ond pok e da i nakon vi e od dvadeset godin nitk ne mo e pobjeæ od tog da se ivot i dalj rj av tak da se najprij sred stvar s koj se iz lo iz rat Zat se na primjer im jedn eks izgovor gotov bezglasn kak bi	bi
se i u zadnj red èul i osjeti sva dram i te in koj to im nos Sasv dovoljn za oè U razgovor za Globus Jelèiæ govor o predstav o net zavr en film koj se bav posljedic rastav o buduæ predstav koj æe radi u Beograd o svoj odnos prem glum o poduèavanj glum na Akademij o Mostar koj nos u seb Za to ste	ste
promijeni naslov predstav Prvotn je Govor glasn im naslov Ponovn poèetk rat Naslov je bio	bio
preeksplicitan obj njavalaèk A i ne rad se o tom da èovjek doð u kaza te s oèekivanj to æe vidjet pa ond to ne doèek jer se ipak rad vi e o slutnj rat neg stvarn poèetk Isprv je to bilo	bilo
zam ljen ka distopij meðut nek su	su
me dogaðaj koj se zbiva iz dan u dan navel da prepozna da je sad njost jednak prijeteæ ka i ta moj idej o nek neizvjesn buduænost Sad njost se pokaza ma tovitij od ma te Poèe sam	sam
se bavi onim to se zbiv sad a to je bilo	bilo
et gor od te sumorn neizvjesnost Kad god zamisl nek lo u situacij na ov prostor realnost te uvijek demantir Na gor naravn to eli prikaza predstav Kad sam	sam
radi Obran i za tit koj se dogað u Mostar ond su	su
me tijek brojn razgovor u Berlin pita za to sam	sam
radi taj film Reka sam	sam
da je svak takav film nek upozorenj nek alarm Misli da je i ov predstav na nek naèin alarm za situacij koj se polak napinj rast a mi tog mo da nism tolik svjesn Naravn da smo	smo
informiran al ka da se izbjegava baci dokraj u to Vidjel smo	smo
tijek nedavn trilatera u Mostar da su	su
sve poruk bile	bile
uvijen a iz njih se ipak vidjel da nem pozitivn pomak Ali ja to promatra pun egzistencijaln konkretn to to znaè Ovdje gleda dram jedn en Da al i niz posljedièn stvar koj se dogað ljud ok nje Ta en dolaz po pomoæ razumijevanj pok av rij it svoj egzistencij i dolaz u Zagreb Sami tim to dolaz u Zagreb on Hrvatsk percipir ka nek Zapad ne to razvijen Ona id na Zapad u Europsk un da pronað sreæ mad dolaz kasn jer im pun godin da bi	bi
kren u nov ivot Sve je to baziran na dogaðaj koj su	su
stvarn zna za tu situacij iz iskustv jedn blisk osob i tu se razvij priè odnos nek kvaz ureðen dr tva prem toj kvazineureðen osob Paradoksaln il logièn situacij je da on u Zagreb nailaz na ljud iz svog kraj a ne na nek nepozna Zagrepèan Kolik je Mostar va okov Pa jest to je okov kojeg se neæ rij it cijelog ivot Sve moj formativn stvar u ivot su	su
se tam dogodi tam mi iv majk i otac sestr velik di familij Sve to me tjer èak i kad neæ da me ivot il osjeæ vra tam Na poèetk To se vid i po govor i po naèin kak tretir stvar to god uèini kolik god ivi izvan tog podruèj uvijek ostaj onakav kakav si	si
napravljen Ka nek lutk na konc Èest je te ko to spozna Od tog ne mo e pobjeæ Pa zat i ne bje	bje
im pop tam tim stvar priè tim impuls ka da sam	sam
sam provodnik za ne to to mi je davn zadan Da zat to jesu	jesu
ok Nemoguæ je nek stvar raskiva bje	bje
at od njih a i ne treba	treba
Za to To sam	sam
ja Na èij ste	ste
stran u predstav Ne smij biti	biti
ni na èij stran to je zabranjen Dobr na èij æu stran ja biti	biti
S kim æu se identificir Pa vjerojatn æe identifikacij biti	biti
i na jedn i na drug stran jer ak tak ne bud ond sam	sam
ja kriv Identifikacij treba	treba
biti	biti
i prem toj osob koj tr i pomoæ i prem ljud koj joj trebaju	trebaju
pr it pomoæ Netk tko je nemoæan uvijek izaziv empatij Je li ta en Brank ispravn Postoj rtv koj nis ispravn Ba sam	sam
glumic Petr Svrtan govori tumaèeæ joj ulog da se kod glavn lik Brank Jadrank Ðokiæ mo da uopæ ne rad o politièk situacij neg o njezin lijenost inertnost nesposobnost da uèin ne to za seb u dvadeset i pet godin Sve im dvij stran a i pozicij rtv se zna zloupotrijebi Ali men je ovdj zanima prij sveg ksenofobij il ak je to te ka rijeè ond inkomodacij odustajanj od vlas rutin koj ti nek gost stranc poremet tim to ti pokuc na vrat kad najmanj oèekuj Boris Kovaèev HANZA MEDIA Kopa po ljudsk du am Jak ste	ste
me iznervir predstav Na kraj tjedn podcrtavajuæ da su	su
stvar drukèij neg to izgleda izvan na prv pogled Pa da zna da je ivot drukèij neg to nam se èin i to glumi seb i drug Je li to hrabrost kopa po du am Ne misli da sam	sam
hrabar Ja prij sveg kopa po vlastit du i prij neg po tuð Kopa jer ne zna drugaèij Ne mogu	mogu
radi nek predstav tekst il film ak to nij dubok moj priè Ako se bav nek tem moram	moram
emotivn zna ne sam egzaktn pun vi e o toj tem neg vi Demon se krij tam gdje ih najmanj oèekuj To se vid i u Na kraj tjedn koj se bav su	su
tin tih demon Ono to mi vidi to je van vrh je leden brijeg a povod su	su
tko zna gdje Ta vez izmeð dubok unutarnjeg i jak vanjsk manifestn vrl je èvrst i meðuovisn I zat je i Na kraj tjedn u grè sve je u tijel u napetost a rijeè su	su
tu zanemariv ne mo e ih se ni sjeti Vi e su	su
brbljanj a svi su	su
u pok aj izlask iz vlastit tijel A to nij moguæ To je tragièn s tim lic Ili s nam sam Nekad voli a nekad ne voli vlastit ivot kak koj dan Ne sasta se uvijek s ljud koj eli i voli Sve to jak negativizir i frustrir Zat èin stvar koj inaè ne bismo	bismo
èini Zat tijel proizvod grè Frustrir li vas rat Pr le su	su
dvadeset tr godin a vi se jo bavi rat Ne bav se ja rat rat se bav mnom Ako èit po internet nek najav da se nek naor ava da se odr ava vojn vje be a govori o BiH	bih
i ak Dodik najavljuj razn stvar ond su	su
te stvar bliz Da djeluj verbaln al tak je i ona rat poèe s par prijetnj i upozorenj A svi su	su
govori daj rat neæ biti	biti
Ona rat nas je nauèi da se sve mo e brz dogodi apt kad se najmanj nad Postoj nek slutnj prijetnj koj èuè tu negdj I treba	treba
kak se zna reæ sam iskr iskric da sve opet bukn Jeste	jeste
li zabrin zbog tog Dakak da se brin misli da zazor im svatk tko je im upuæen u te stvar Ne treba	treba
strahova jer je to idiotsk al da zabrinutost je sasv zadovoljavajuæ rijeè Treba	treba
biti	biti
zabrin A Mostar Kad doð u Mostar im ambivalentan osjeæ Odrasta sam	sam
u Mostar koj je bio	bio
jedan grad a danas postoj ljud koj nis bili	bili
na jedn il drug stran Kad u grad koj nij velik postoj jedan takav odnos samozabran prelask ka da vi recim nikad ne odet u Zagreb dalj od Frankopansk ond to veæ stvar poseban osjeæ pristank na ogranièenost Taj pristanak koj je sad veæ dobrovoljn on je to nervir a posebn kad si	si
u mal grad jer je ogranièen sami tim to je malen Jedn sam	sam
spomen antiæev pjesm o Emin To je pjesm o multikulturalnost On Srbin zaljubljen je u Muslimank Pat a zna da je neæ moæ imat i ne bor se protiv tog neg prihvaæ Nij li to grozn Da grozn je al on to prihvaæ On nij agresivn u moment u koj netk prihvaæ drug takv kakav jest ja sam	sam
sretan s tim S tim manjk agresij On prista na razlièitost to je poruk Biste	biste
li vi tak ne to prihvati Odusta rtvova se rad tuð sreæ Polak dr e polak korak po korak ovdj govori o prihvaæanj mi se jo tom moramo	moramo
uèit Za Bogdan Dikliæ su	su
vam posla SMS Te ak èovjek odlièan glumc to bi	bi
pisa u SMS u o vam Pa vjerojatn ist Bar prv di poruk Kak je glumc s vam Hm ja nema problem s njim dapaè pun tog to ja radi se zasniv uprav na njim na proces rad pa im to misli pa e A misli da ni on nema sa mnom Dost sam	sam
posveæen proces i na njeg zaprav tr im najv e vremen da se lik koji se glumc bav stabilizir da bi	bi
uopæ do ao do autorsk pozicij koj je i jedan od ciljev tog èim se ja bav Mal kad pok em agresij rijetk vik nem Proces je dost osjetljiv osoban pipav A opet glum je za men tak irok i bogat tem da bih	bih
o tom mog sat ne zna odakl da poèn Nat a Rajkoviæ i ja smo	smo
jo 90 ih kren na ova naèin redi teatar otvarajuæ uprav tem koj bi	bi
se teatar u buduænost treba bavi ka to je autorsk pozicij glumc Boris Kovaèev HANZA MEDIA Iak rad na predstav naziva proces u njem sudjeluj glumc vi zna gotov u detalj kak stvar mora	mora
izgleda Na prob ste	ste
u jedn trenutk rekl ne to obj njavajuæ ja sam	sam
to davn seb postavi Da bez tog nem ni ta Trener u nogomet postav igraè u odreðen sistem na primjer 4 4 2 i igraè im pun slobod unutar tog Ne postoj slobod bez granic Svatk mora	mora
imat granic da bi	bi
bio	bio
slobodan inaè smo	smo
u anarhij Postavi granic na nek je naèin su	su
tinsk pitanj posl koji se bav i ond unutar tog omoguæit èovjek da izað izvan njih Za to je potrebn to bi	bi
reka Èervar anticipacij do detalj ak je to moguæ Ili nogometn taktik Odakl vi u Kerempuh Nij ba da inaè radi satir Du ko Lju tin me pun put zva al nikak da se to dogod iz razn razlog Opir sam	sam
se jer moj rad ne podlij e tak striktn anrovsk odrednic I kak sam	sam
to staln odbija Lju tin mi je na kraj govori Doð i rad to hoæ ne mora	mora
biti	biti
satir No pretvori sam	sam
a tom sam	sam
inaè sklon dost tog to radi u iron to je s film Sam	sam
samca je gotov Nek dan je stavljen kolor i sad æe ga producentic Zdenk Gold slat na vanjsk festiva Vidjet æem kak æe proæ O kakv je film rijeè Hti sam	sam
pokaza kolik zaprav èovjek ne mo e biti	biti
on to bi	bi
hti biti	biti
i kolik ovis o odnos koj su	su
negdj dubok u njem zakopan kolik je formiran bog te pita kad i gdje a da tog uopæ nij svjestan i da se stvar mijenja unutar braèn odnos da otac u nek moment postaj majk il majk otac a da to zakon il institucij nikak ne pra Rastav je situacij u koj al ba nitk nij na dobitk A drugaèij se ne mo e Pa ipak se èovjek dovij iak je svjestan da ne mo e ni ta popravi on se ipak trud popravi a popravi se vi e ne mo e ni ta i tak dalj A dijet treba	treba
obitelj koj vi e nem pa on sam sklap puzzl od on to im Iz sveg tog nasta cijel niz pitanj koj sam	sam
im potreb iskomunicir s ljud koj tog mo da nis svjesn Ja sam	sam
i sam	sam
pr ao nek situacij za koj ne smi reæ da je specijaln jer su	su
je pr li mnog drug koj su	su
se rasta Èini mi se da sam	sam
mora podijeli to iskustv jer misli da se to mal zna Na primjer Obiteljsk zakon se mijenja pet put pa je vraæen na on verzij iz 2003 a sad se treba	treba
donijet nov verzij koj nitk nij zadovoljn Za to se tak dug to rj av Oèit to nij lak Ne mo e lak rij it pitanj emotivn narav pitanj usvajanj i razn drug Za to èak ne kriv ni sustav ni ljud koj u njem rad socijaln radnik i sve osta jer nis on kriv Pitanj je naprost zajeban i te ko ga je rij it Nem ist razvod nem ist situacij a postoj pranc po koj se sve rad A po pranc se ni ta ne da rij it Postoj li nek priè koj nosi koj eli napravi Oh da Mnog Najvjerojatn æu nakon ov iæ u Jugoslavensk dramsk pozor te JDP radi nov predstav To je presedan za men jer se nikad nij slo il tolik mnog posl koj moram	moram
napravi u tak kratk vrijem al tak je ispa ov godin Evo u Beograd æu radi jedn Fassbinder recim Tam jo nisa radi I to jak brz nakon ov premijer to je ist presedan za men ta brzin izmeð jedn i drug projekt Boris Kovaèev HANZA MEDIA Za to predajet na Akademij Pozva me da predaj Vjeran Zupp kad je do ao tam za dekan Bilo	bilo
mi je to nezamisliv jer sam	sam
ja ot ao s nje nezadovoljn niz stvar Reka sam	sam
mu da neæ a ond me na razn naèin uvjerava i uvjeri Naravn poèe sam	sam
radi s divn generacij u koj su	su
ev i glumc iz ov predstav Mark Makovièiæ Nik a Butijer Jadrank Ðokiæ Jerk Marèiæ Bili	bili
su	su
klinc al bili	bili
su	su
genijaln Poèel smo	smo
radi i to me osvoji zavol to to vam je bli e kaza te il film Kaza te To je prijenos u iv a to film ne mo e do te mjer Kaza te je jedin umjetnost koj id u iv Dogað se ova èas pred tvoji oè i nikad vi e tvoj do ivlja je jedinstven Jer kad je veæ u iv za to ond ne iskoristit sve on to taj direktn prijenos nud recim sluèajnost recim da padn luster sa strop da se stvar dogað spontanij da mu se dopust ta slobod nepreciznost A opet s drug stran nem kaza ta koj mo e sublimir stvarnost kak to mo e film Voli oboj podjednak Za to ne skida glumic i glumc Prv sam	sam
put vidi nek golog na scen misli da je bio	bio
mu karc negdj osamdeseti godin Nakon tog sam	sam
vidi niz predstav s goli ljud Nakon nek vremen to mi je posta ka nek lo vic nij vi e bilo	bilo
okantn Posta je ne to ka lo a for Ako men ka redatelj to ne uzbuðuj ond æe te ko to uzbudi nek u public Vi e me raduj ak nek glumic dign suknj i pok e svoj tijel s jasn razlog To sad im na ispit na Akademij Jednostavn izliza se for to æe ti for ak je izlizan Ili seks na film Uglavn nespretn i neuvjerljiv Hoæ li predstav Govor glasn biti	biti
dobr Mogu	mogu
reæ da æe biti	biti
jak moj a nada se da æe se uklopi u nek buduæ repertoar Kerempuh To joj najtoplij eli I eli reæ da sam	sam
radi s divn glumc Vilim Matul Brank Trlin Nin Erak Nik om Butijer Mij Anoèiæ Jadrank Ðokiæ Petr Svrtan Mark Makovièiæ Damir Poljièak Vratim se na Mostar u rat Izbjegl ste	ste
mi reæ osobn doja o rat Kad ste	ste
vidjel to Hrva rad u BiH	bih
kak ste	ste
se osjeæ Pun tog se dogodi al da ne dulji uzmi sam logor I prit zanemari èinjenic da ih je bilo	bilo
na svim stran jer to je mantr koj se ponavlj ne bi	bi
li se na lo nekakv opravdanj Predmet na eg bavljenj moraju	moraju
biti	biti
on koj su	su
bili	bili
na hrvatsk stran Hoæ reæ treba bi	bi
da se svak bav svoj a ne svi tuð kak se to veæ dogað u na em politièk ivot Valjd je veæ vrijem da se ta retorik promijen Jer tko normaln mo e to opravda Jutarnj list Copyright HANZA MEDIA d o o Sva prav pridr an Izdvaja Najèitanij Iz drug medij Jutarnj list Copyright HANZA MEDIA d o o Sva prav pridr an Izdvaja Najèitanij Iz drug medij Automobilsk industrij opet bilj i rast prodaj pa je tak u veljaè ov godin registriran 1 16 milijun novi automobi to je 4 2 post vi e neg u ist razdoblj pr le godin Uz to rijeè je o najbolj rezulta jo od 2008 godin Ono to je zanimljiv je da je uz rast na najveæ tr i tim poput tr i ta Njemaèk panjolsk i Francusk najveæ rast zabilj en u Hrvatsk Naim kod nas je prvenstven zbog smanjenj tr arin zbog kojeg su	su
automobi posta ne to jeftin br registriran novi vozil porasta za 46 8 post u odnos na pr lu godin Da je rijeè o ogromn rast govor i podatk da drug najveæ rast iznos 30 post u Grèk dok treæeplasiran Maðarsk bilj i rast od 24 post JATO Najpopularn su	su
oèekivan SUV model koj su	su
èini èak 33 post europsk prodaj u veljaè Analitièar Felip Munoz iz kompanij JATO koj je objavi ov podatk izjavi je kak bi	bi
europsk tr i te treba nastavi s rast al za oèekiva je kak æe taj rast biti	biti
vezan uz dobr rezulta na nekolik kljuèn tr i ta jer je na èak 13 od 27 tr i ta zabilj en pad Prodaj dizelsk model je u slobodn pad to i ne èud s obzir na sve veæ restrikcij i neizvjesn buduænost Ljud su	su
u stra da æe njihov nov automobi kroz koj godin biti	biti
zabranjen u centr grad i zbog tog odusta od kupnj dizel a Udi dizel a u prodaj nastavlj pada i u veljaè je iznosi 39 5 post to je èak 12 8 post manj neg u ist razdoblj pr le godin Na taj pad najv e je utjeca pad potr nje za dizelsk vozil u Njemaèk i Velik Britanij gdje je prodaj dizel a pal za vi e od 19 post 19 2 post u Njemaèk i 23 5 post u Velik Britanij S drug stran benzinc postaj sve tr en i bilj e rast od 16 post u veljaè izjavi je Munoz JATO Volkswagen je i dalj vodeæ kad je u pitanj br prodan automobi a slijed ga Renault i Peugeot Najpopularn model með europsk kupc u veljaè bio	bio
je Volkswagen Golf JATO Jutarnj list Copyright HANZA MEDIA d o o Sva prav pridr an Izdvaja Najèitanij Iz drug medij 